##########
#b  X   X#
#        #
#   C    #
#        #
#        #
#      # #
#  C   #C#
#     O# #
#  X   #E#
##########